##########
#  *     #
###### ###
#        #
### ######
#        #
########@#
